0,1333172439,2012-03-31T12:40:39.590113-07:00,And here's a downvote.,63470,rmqjs,32657,funny,30813,1333197639,1844,622,Animates_Everything
0,1333178161,2012-03-31T14:16:01.093638-07:00,Expectation,35,rmun4,29,GifSound,6,1333203361,23,3,Gangsta_Raper
0,1333199913,2012-03-31T20:18:33.192906-07:00,Downvote,41,rna86,32,GifSound,9,1333225113,23,0,Gangsta_Raper
0,1333252330,2012-04-01T10:52:10-07:00,Every time I downvote something,10,ro7e4,6,GifSound,4,1333277530,2,0,Gangsta_Raper
0,1333272954,2012-04-01T16:35:54.393381-07:00,Downvote &quot;Dies Irae&quot;,65,rooof,57,GifSound,8,1333298154,49,0,Gangsta_Raper
0,1333761060,2012-04-07T08:11:00-07:00,"Demolished, every time you downvote someone",40,rxwjg,17,gifs,23,1333786260,-6,3,Hellothereawesome
0,1335503834,2012-04-27T12:17:14.103167-07:00,how i feel whenever i submit here,104,svpq7,67,fffffffuuuuuuuuuuuu,37,1335529034,30,12,
0,1339160075,2012-06-08T19:54:35.421944-07:00,getting that first downvote on a new post,13,usmxn,5,funny,8,1339185275,-3,0,
0,1339407879,2012-06-11T16:44:39.947798-07:00,How reddit seems to reacts whenever I share a milestone that I passed,14,uwzrd,6,funny,8,1339433079,-2,0,
0,1339425291,2012-06-11T21:34:51.692933-07:00,Every LastAirBender post with a NSFW tag,20,uxf5q,9,pics,11,1339450491,-2,0,HadManySons
0,1340008115,2012-06-18T15:28:35.800140-07:00,How I felt when i forgot to put &quot;spoiler&quot; in a comment,21,v8vl7,10,gifs,11,1340033315,-1,0,TraumaticASH
0,1340020566,2012-06-18T18:56:06.440319-07:00,What r/AskReddit did to me when I asked something about 9gag.,271,v970d,210,gifs,61,1340045766,149,5,MidgetDance1337
0,1340084902,2012-06-19T12:48:22.539790-07:00,My brother when he found my reddit account.,8494,vah9p,4612,funny,3882,1340110102,730,64,Pazzaz
0,1341036761,2012-06-30T13:12:41.517254-07:00,The reaction i face when i express a view for religion.,23,vuqcr,15,atheism,8,1341061961,7,4,
0,1341408717,2012-07-04T20:31:57.182234-07:00,How I feel on r/atheism,21,w27bp,8,funny,13,1341433917,-5,3,koolkows
0,1341779603,2012-07-09T03:33:23.514877-07:00,When I see a rage comic out of its sub Reddit.,24,w9k12,14,funny,10,1341804803,4,0,Moncole
0,1342782548,2012-07-20T18:09:08.903673-07:00,Sitting as a /new knight of /r/gaming seeing all the insanely twisted shadow planet flash sale posts.,21,wwjak,8,gaming,13,1342807748,-5,4,shortguy014
0,1343172264,2012-07-25T06:24:24.535558-07:00,How I act when I see a &quot;How I feel when..&quot; post in /r/funny,14,x4ogv,6,funny,8,1343197464,-2,0,Killer2000
0,1343626962,2012-07-30T12:42:42.262869-07:00,"Ohhh, that's a lovely picture of your country.",14,xenyw,7,pics,7,1343652162,0,0,todaysuckstomorrow
0,1344874478,2012-08-13T23:14:38-07:00,Pretty much what happened to my pixel art post on /r/minecraft.,1,y6v1k,1,gifs,0,1344899678,1,0,
0,1344923101,2012-08-14T12:45:01-07:00,Anatomy of a downvote,167,y7wwi,97,gifs,70,1344948301,27,6,LazyBurnbaby
0,1347339289,2012-09-11T04:54:49+00:00,Whenever I See a Post Complaining About Downvotes,10,zp04o,6,funny,4,1347339289,2,0,
0,1347771382,2012-09-16T04:56:22+00:00,Seeing the same thing posted multiple times by the same person in 'new',56,zyk4s,39,funny,17,1347771382,22,0,azcomputerguru
0,1347806800,2012-09-16T21:46:40-07:00,"Seeing something you posted yesterday on the front page, posted by someone else",14,100bfe,9,funny,5,1347832000,4,0,IronOxide42
0,1347923765,2012-09-17T23:16:05+00:00,When I remember it's Monday...,3,101rif,1,funny,2,1347923765,-1,0,
0,1348431656,2012-09-23T20:20:56+00:00,Destructive downvote,257,10ctqr,219,GifSound,38,1348431656,181,14,Gangsta_Raper
0,1348800190,2012-09-28T02:43:10+00:00,How I Reddit when drinking bourbon whiskey. Sorry everyone. (gif.),21,10llkg,10,funny,11,1348800190,-1,4,CrowKaneII
1,1347043558,2012-09-07T18:45:58+00:00,This is incredible; note how the faces look before you stare at the center of the image,78,zio2h,60,gifs,18,1347043558,42,12,Hysteriia
1,1347164191,2012-09-09T04:16:31+00:00,What the...,4,zl7eu,2,gif,2,1347164191,0,0,IronicIvan
1,1351825236,2012-11-02T03:00:36+00:00,The faces...,122,12huw6,92,WTF,30,1351825236,62,23,CeruleanThunder
1,1351934419,2012-11-03T09:20:19+00:00,"Definitely one of the weirder GIFs I've come across. Look at the text in the centre, the faces in your peripheral vision will become increasingly fucked up, but the second you look directly at the faces they'll become normal.",13121,12k4kx,7452,WTF,5669,1351934419,1783,294,The_Bhuda_Palm
1,1352759302,2012-11-12T22:28:22+00:00,Look in the middle,14,1335av,1,WTF,13,1352759302,-12,3,LOUD_DUCK
100,1358858328,2013-01-22T12:38:48+00:00,Included in the informational packet given to performing artists before a sporting event.,8,171vu0,5,funny,3,1358858328,2,0,Sarbanes_Foxy
100,1358871815,2013-01-22T16:23:35+00:00,how people tend to sing the national anthem at sporting events these days,10,17272u,7,pics,3,1358871815,4,3,awcreative
100,1358873901,2013-01-22T16:58:21+00:00,Star Spangled Banner - Sporting Event Version,5,1729gb,4,funny,1,1358873901,3,0,potato1
100,1358874067,2013-01-22T17:01:07+00:00,How to sing the national anthem at a sporting event.,15104,1729nd,8548,funny,6556,1358874067,1992,352,watcher_of_the_skies
100,1358880415,2013-01-22T18:46:55+00:00,Star Spangled Banner - Sporting Event Edition,13,172htq,8,funny,5,1358880415,3,0,tianan
100,1358882437,2013-01-22T19:20:37+00:00,Star Spangled Banner: Sporting Event Version,19,172ki8,11,funny,8,1358882437,3,2,
100,1358893345,2013-01-22T22:22:25+00:00,Star Spangled Banner - Sporting Event Version,13,172zeg,8,funny,5,1358893345,3,0,Spam4119
100,1358895795,2013-01-22T23:03:15+00:00,How the American national anthem is generally performed in public.,6,1732pc,3,pics,3,1358895795,0,2,
100,1358898147,2013-01-22T23:42:27+00:00,As painfully slow as possible.,12,1735pk,5,funny,7,1358898147,-2,0,
100,1358899057,2013-01-22T23:57:37+00:00,How to sing the Star Spangled Banner,9,1736um,2,funny,7,1358899057,-5,0,beardface909
100,1358950344,2013-01-23T14:12:24+00:00,Sheet Music for the Star Spangled Banner (Sporting Event Version),12,174egv,4,funny,8,1358950344,-4,3,Rockytriton
100,1359024481,2013-01-24T10:48:01+00:00,So I hear Alicia Keys will be opening the Super Bowl...,8,176mtx,2,funny,6,1359024481,-4,2,